111111111111111111111111111111111111111111111111111
111111111111111111111111111111111111111111111111111
111111111111111111111111111111111111111111111111111
111111111111111111111111111111111111111111111111111
111111111111111111111111111111111111111111111111111
111111111111111111111111111111111111111111111111111
111111111111111111111111111111111111111111111111111
111111111111111111111111111111111111111111111111111
111111111111111111111111111111111111111111111111111
111111111111111111111111111111111111111111111111111
111111111121000000000001020000000000000021111111111
111111111101011110011101000000000000000001111111111
111111111101010010010101000000000000000001111111111
111111111100010000010101000000000000000001111111111
111111111101110110010101000000000000000001111111111
111111111101000010010101000000000000000001111111111
111111111101001011110000000000000000000001111111111
111111111101111010000000000000000000000001111111111
111111111100000010000000000000000000000001111111111
111111111111111110000000000000000000000001111111111
111111111100000000000000000000000000000001111111111
111111111100000000000000010000000000000001111111111
111111111100000000000000020000000000000001111111111
111111111120000000000001232100000000000021111111111
111111111100000000000000020000000000000001111111111
111111111100000000000000010000000000000001111111111
111111111100000000000000000000000000000001111111111
111111111100000000000000000000000000000001111111111
111111111100000000000000000000000000000001111111111
111111111100000000000000000000000000000001111111111
111111111100000000000000000000000000000001111111111
111111111100000000000000000000000000000001111111111
111111111100000000000000000000000000000001111111111
111111111100000000000000000000000000000001111111111
111111111100000000000000000000000000000001111111111
111111111100000000000000000000000000000001111111111
111111111120000000000000020000000000000021111111111
111111111111111111111111111111111111111111111111111
111111111111111111111111111111111111111111111111111
111111111111111111111111111111111111111111111111111
111111111111111111111111111111111111111111111111111
111111111111111111111111111111111111111111111111111
111111111111111111111111111111111111111111111111111
111111111111111111111111111111111111111111111111111
111111111111111111111111111111111111111111111111111
111111111111111111111111111111111111111111111111111
111111111111111111111111111111111111111111111111111


