0000000000000000000001
0000000000000000000001
0000000000000000000001
0000000000000000000001
0000000000000000000001
0000000000000000000001
0000000000000000000001
0000000000000000000001
0000000000300000000001
0000000000200000000001
0000000032123000000001
0000000000200000000001
0000000000300000000001
0000000000000000000001
0000000000000000000001
0000000000000000000001
0000000000000000000001
0000000000000000000001
0000000000000000000001
0000000000000000000001
0000000000000000000001
1111111111111111111111
