11111111111111111111111111
00000000000000000000011111
00000000000000000000011111
00000000000000000000011111
00000000000000000000011111
00000000000000000000011111
00000000000000000000011111
00000000000000000000011111
00000000003000000000011111
00000000002000000000011111
00000000321230000000011111
00000000002000000000011111
00000000003000000000011111
00000000000000000000011111
00000000000000000000011111
00000000000000000000011111
00000000000000000000011111
00000000000000000000011111
00000000000000000000011111
00000000000000000000011111
00000000000000000000011111
00000000000000000000011111
00000000000000000000011111
00000000000000000000011111
00000000000000000000011111
00000000000000000000011111
00000000000000000000011111
00000000000000000000011111
00000000000000000000011111
11111111111111111111111111

