111111111111111111111111111111111111111111111111111
111111111111111111111111111111111111111111111111111
111111111111111111111111111111111111111111111111111
111111111111111111111111111111111111111111111111111
111111111111111111111111111111111111111111111111111
111111111111111111111111111111111111111111111111111
111111111111111111111111111111111111111111111111111
111111111111111111111111111111111111111111111111111
111111111111111111111111111111111111111111111111111
111111111111111111111111111111111111111111111111111
111111111120000000000000020000000000000021111111111
111111111100000000000000000000000000000001111111111
111111111100000000000000000000000000000001111111111
111111111100000000000000000000000000000001111111111
111111111100000000000000000000000000000001111111111
111111111100000000000000000000000000000001111111111
111111111100000000000000000000000000000001111111111
111111111100000000000000000000000000000001111111111
111111111100000000000000000000000000000001111111111
111111111100000000000000000000000000000001111111111
111111111100000000000000000000000000000001111111111
111111111100000000000000010000000000000001111111111
111111111100000000000000020000000000000001111111111
111111111120000000000001232100000000000021111111111
111111111100000000000000020000000000000001111111111
111111111100000000000000010000000000000001111111111
111111111100000000000000000000000000000001111111111
111111111100000000000000000000000000000001111111111
111111111100000000000000000000000000000001111111111
111111111100000000000000000000000000000001111111111
111111111100000000000000000000000000000001111111111
111111111100000000000000000000000000000001111111111
111111111100000000000000000000000000000001111111111
111111111100000000000000000000000000000001111111111
111111111100000000000000000000000000000001111111111
111111111100000000000000000000000000000001111111111
111111111120000000000000020000000000000021111111111
111111111111111111111111111111111111111111111111111
111111111111111111111111111111111111111111111111111
111111111111111111111111111111111111111111111111111
111111111111111111111111111111111111111111111111111
111111111111111111111111111111111111111111111111111
111111111111111111111111111111111111111111111111111
111111111111111111111111111111111111111111111111111
111111111111111111111111111111111111111111111111111
111111111111111111111111111111111111111111111111111
111111111111111111111111111111111111111111111111111


