101000000101000000101000000101000000101000000101000000101000000101000000101000000101000000101000000101000000101000000101000000101000000101000000101000000101000000101000000101000000101000000101000000101000000101000000101000000101000000101000000101000000101000000101000000101000000101000000101000000101000000101000000101000000101000000101000000101000000101000000101000000101000000101000000101000000101000000101000000101000000101000000101000000101000000101000000
101000000101000000101000000101000000101000000101000000101000000101000000101000000101000000101000000101000000101000000101000000101000000101000000101000000101000000101000000101000000101000000101000000101000000101000000101000000101000000101000000101000000101000000101000000101000000101000000101000000101000000101000000101000000101000000101000000101000000101000000101000000101000000101000000101000000101000000101000000101000000101000000101000000101000000101000000
101000000101000000101000000101000000101000000101000000101000000101000000101000000101000000101000000101000000101000000101000000101000000101000000101000000101000000101000000101000000101000000101000000101000000101000000101000000101000000101000000101000000101000000101000000101000000101000000101000000101000000101000000101000000101000000101000000101000000101000000101000000101000000101000000101000000101000000101000000101000000101000000101000000101000000101000000
101000000101000000101000000101000000101000000101000000101000000101000000101000000101000000101000000101000000101000000101000000101000000101000000101000000101000000101000000101000000101000000101000000101000000101000000101000000101000000101000000101000000101000000101000000101000000101000000101000000101000000101000000101000000101000000101000000101000000101000000101000000101000000101000000101000000101000000101000000101000000101000000101000000101000000101000000
101000000101000000101000000101000000101000000101000000101000000101000000101000000101000000101000000101000000101000000101000000101000000101000000101000000101000000101000000101000000101000000101000000101000000101000000101000000101000000101000000101000000101000000101000000101000000101000000101000000101000000101000000101000000101000000101000000101000000101000000101000000101000000101000000101000000101000000101000000101000000101000000101000000101000000101000000
101000000101000000101000000101000000101000000101000000101000000101000000101000000101000000101000000101000000101000000101000000101000000101000000101000000101000000101000000101000000101000000101000000101000000101000000101000000101000000101000000101000000101000000101000000101000000101000000101000000101000000101000000101000000101000000101000000101000000101000000101000000101000000101000000101000000101000000101000000101000000101000000101000000101000000101000000
101000000101000000101000000101000000101000000101000000101000000101000000101000000101000000101000000101000000101000000101000000101000000101000000101000000101000000101000000101000000101000000101000000101000000101000000101000000101000000101000000101000000101000000101000000101000000101000000101000000101000000101000000101000000101000000101000000101000000101000000101000000101000000101000000101000000101000000101000000101000000101000000101000000101000000101000000
101000000101000000101000000101000000101000000101000000101000000101000000101000000101000000101000000101000000101000000101000000101000000101000000101000000101000000101000000101000000101000000101000000101000000101000000101000000101000000101000000101000000101000000101000000101000000101000000101000000101000000101000000101000000101000000101000000101000000101000000101000000101000000101000000101000000101000000101000000101000000101000000101000000101000000101000000
101000000101000000101000000101000000101000000101000000101000000101000000101000000101000000101000000101000000101000000101000000101000000101000000101000000101000000101000000101000000101000000101000000101000000101000000101000000101000000101000000101000000101000000101000000101000000101000000101000000101000000101000000101000000101000000101000000101000000101000000101000000101000000101000000101000000101000000101000000101000000101000000101000000101000000101000000
101000000101000000101000000101000000101000000101000000101000000101000000101000000101000000101000000101000000101000000101000000101000000101000000101000000101000000101000000101000000101000000101000000101000000101000000101000000101000000101000000101000000101000000101000000101000000101000000101000000101000000101000000101000000101000000101000000101000000101000000101000000101000000101000000101000000101000000101000000101000000101000000101000000101000000101000000
101000000101000000101000000101000000101000000101000000101000000101000000101000000101000000002000000101000000000000000000000000000000000000000000101000000101000000000000000000000000000000000000000000000000000000000000000000000002000000000000000000000000000000000000000000000000000000000000000000000000000000000000000000000000000000000000000000000000000000000000002000000101000000101000000101000000101000000101000000101000000101000000101000000101000000101000000
101000000101000000101000000101000000101000000101000000101000000101000000101000000101000000000000000101000000000000000101000000101000000000000000000000000101000000000000000000000000000000000000000000000000000000000000000000000000000000000000000000000000000000000000000000000000000000000000000000000000000000000000000000000000000000000000000000000000000000000000000000000101000000101000000101000000101000000101000000101000000101000000101000000101000000101000000
101000000101000000101000000101000000101000000101000000101000000101000000101000000101000000000000000101000000000000000000000000101000000000000000101000000101000000101000000101000000000000000000000000000000000000000000000000000000000000000000000000000000000000000000000000000000000000000000000000000000000000000000000000000000000000000000000000000000000000000000000000000101000000101000000101000000101000000101000000101000000101000000101000000101000000101000000
101000000101000000101000000101000000101000000101000000101000000101000000101000000101000000000000000000000000000000000000000000101000000000000000000000000000000000000000000101000000000000000000000000000000000000000000000000000000000000000000000000000000000000000000000000000000000000000000000000000000000000000000000000000000000000000000000000000000000000000000000000000101000000101000000101000000101000000101000000101000000101000000101000000101000000101000000
101000000101000000101000000101000000101000000101000000101000000101000000101000000101000000101000000101000000101000000000000000101000000101000000101000000101000000000000000101000000000000000000000000000000000000000000000000000000000000000000000000000000000000000000000000000000000000000000000000000000000000000000000000000000000000000000000000000000000000000000000000000101000000101000000101000000101000000101000000101000000101000000101000000101000000101000000
101000000101000000101000000101000000101000000101000000101000000101000000101000000101000000000000000000000000000000000000000000101000000000000000000000000101000000000000000101000000000000000000000000000000000000000000000000000000000000000000000000000000000000000000000000000000000000000000000000000000000000000000000000000000000000000000000000000000000000000000000000000101000000101000000101000000101000000101000000101000000101000000101000000101000000101000000
101000000101000000101000000101000000101000000101000000101000000101000000101000000101000000101000000101000000101000000000000000101000000000000000101000000101000000000000000101000000000000000000000000000000000000000000000000000000000000000000000000000000000000000000000000000000000000000000000000000000000000000000000000000000000000000000000000000000000000000000000000000101000000101000000101000000101000000101000000101000000101000000101000000101000000101000000
101000000101000000101000000101000000101000000101000000101000000101000000101000000101000000000000000000000000101000000000000000000000000000000000101000000000000000000000000000000000000000000000000000000000000000000000000000000000000000000000000000000000000000000000000000000000000000000000000000000000000000000000000000000000000000000000000000000000000000000000000000000101000000101000000101000000101000000101000000101000000101000000101000000101000000101000000
101000000101000000101000000101000000101000000101000000101000000101000000101000000101000000000000000000000000101000000101000000101000000101000000101000000000000000000000000000000000000000000000000000000000000000000000000000000000000000000000000000000000000000000000000000000000000000000000000000000000000000000000000000000000000000000000000000000000000000000000000000000101000000101000000101000000101000000101000000101000000101000000101000000101000000101000000
101000000101000000101000000101000000101000000101000000101000000101000000101000000101000000000000000000000000000000000000000000000000000000000000000000000000000000000000000000000000000000000000000000000000000000000000000000000000000000000000000000000000000000000000000000000000000000000000000000000000000000000000000000000000000000000000000000000000000000000000000000000101000000101000000101000000101000000101000000101000000101000000101000000101000000101000000
101000000101000000101000000101000000101000000101000000101000000101000000101000000101000000000000000000000000000000000000000000000000000000000000000000000000000000000000000000000000000000000000000000000000000000000000000000000000000000000000000000000000000000000000000000000000000000000000000000000000000000000000000000000000000000000000000000000000000000000000000000000101000000101000000101000000101000000101000000101000000101000000101000000101000000101000000
101000000101000000101000000101000000101000000101000000101000000101000000101000000101000000000000000000000000000000000000000000000000000000000000000000000000000000000000000000000000000000000000000000000000000000000000000000000000000000000000000000000000000000000000000000000000000000000000000000000000000000000000000000000000000000000000000000000000000000000000000000000101000000101000000101000000101000000101000000101000000101000000101000000101000000101000000
101000000101000000101000000101000000101000000101000000101000000101000000101000000101000000000000000000000000000000000000000000000000000000000000000000000000000000000000000000000000000000000000000000000000000000000000000000000000000000000000000000000000000000000000000000000000000000000000000000000000000000000000000000000000000000000000000000000000000000000000000000000101000000101000000101000000101000000101000000101000000101000000101000000101000000101000000
101000000101000000101000000101000000101000000101000000101000000101000000101000000101000000000000000000000000000000000000000000000000000000000000000000000000000000000000000000000000000000000000000000000000000000000000000000000000000000000000000000000000000000000000000000000000000000000000000000000000000000000000000000000000000000000000000000000000000000000000000000000101000000101000000101000000101000000101000000101000000101000000101000000101000000101000000
101000000101000000101000000101000000101000000101000000101000000101000000101000000101000000000000000000000000000000000000000000000000000000000000000000000000000000000000000000000000000000000000000000000000000000000000000000000000000000000000000000000000000000000000000000000000000000000000000000000000000000000000000000000000000000000000000000000000000000000000000000000101000000101000000101000000101000000101000000101000000101000000101000000101000000101000000
101000000101000000101000000101000000101000000101000000101000000101000000101000000101000000000000000000000000000000000000000000000000000000000000000000000000000000000000000000000000000000000000000000000000000000000000000000000000000000000000000000000000000000000000000000000000000000000000000000000000000000000000000000000000000000000000000000000000000000000000000000000101000000101000000101000000101000000101000000101000000101000000101000000101000000101000000
101000000101000000101000000101000000101000000101000000101000000101000000101000000101000000000000000000000000000000000000000000000000000000000000000000000000000000000000000000000000000000000000000000000000000000000000000000000101000000000000000000000000000000000000000000000000000000000000000000000000000000000000000000000000000000000000000000000000000000000000000000000101000000101000000101000000101000000101000000101000000101000000101000000101000000101000000
101000000101000000101000000101000000101000000101000000101000000101000000101000000101000000000000000000000000000000000000000000000000000000000000000000000000000000000000000000000000000000000000000000000000000000000000000000000002000000000000000000000000000000000000000000000000000000000000000000000000000000000000000000000000000000000000000000000000000000000000000000000101000000101000000101000000101000000101000000101000000101000000101000000101000000101000000
101000000101000000101000000101000000101000000101000000101000000101000000101000000101000000002000000000000000000000000000000000000000000000000000000000000000000000000000000000000000000000000000000000000000000101000000002000000003000000002000000101000000000000000000000000000000000000000000000000000000000000000000000000000000000000000000000000000000000000000000002000000101000000101000000101000000101000000101000000101000000101000000101000000101000000101000000
101000000101000000101000000101000000101000000101000000101000000101000000101000000101000000000000000000000000000000000000000000000000000000000000000000000000000000000000000000000000000000000000000000000000000000000000000000000002000000000000000000000000000000000000000000000000000000000000000000000000000000000000000000000000000000000000000000000000000000000000000000000101000000101000000101000000101000000101000000101000000101000000101000000101000000101000000
101000000101000000101000000101000000101000000101000000101000000101000000101000000101000000000000000000000000000000000000000000000000000000000000000000000000000000000000000000000000000000000000000000000000000000000000000000000101000000000000000000000000000000000000000000000000000000000000000000000000000000000000000000000000000000000000000000000000000000000000000000000101000000101000000101000000101000000101000000101000000101000000101000000101000000101000000
101000000101000000101000000101000000101000000101000000101000000101000000101000000101000000000000000000000000000000000000000000000000000000000000000000000000000000000000000000000000000000000000000000000000000000000000000000000000000000000000000000000000000000000000000000000000000000000000000000000000000000000000000000000000000000000000000000000000000000000000000000000101000000101000000101000000101000000101000000101000000101000000101000000101000000101000000
101000000101000000101000000101000000101000000101000000101000000101000000101000000101000000000000000000000000000000000000000000000000000000000000000000000000000000000000000000000000000000000000000000000000000000000000000000000000000000000000000000000000000000000000000000000000000000000000000000000000000000000000000000000000000000000000000000000000000000000000000000000101000000101000000101000000101000000101000000101000000101000000101000000101000000101000000
101000000101000000101000000101000000101000000101000000101000000101000000101000000101000000000000000000000000000000000000000000000000000000000000000000000000000000000000000000000000000000000000000000000000000000000000000000000000000000000000000000000000000000000000000000000000000000000000000000000000000000000000000000000000000000000000000000000000000000000000000000000101000000101000000101000000101000000101000000101000000101000000101000000101000000101000000
101000000101000000101000000101000000101000000101000000101000000101000000101000000101000000000000000000000000000000000000000000000000000000000000000000000000000000000000000000000000000000000000000000000000000000000000000000000000000000000000000000000000000000000000000000000000000000000000000000000000000000000000000000000000000000000000000000000000000000000000000000000101000000101000000101000000101000000101000000101000000101000000101000000101000000101000000
101000000101000000101000000101000000101000000101000000101000000101000000101000000101000000000000000000000000000000000000000000000000000000000000000000000000000000000000000000000000000000000000000000000000000000000000000000000000000000000000000000000000000000000000000000000000000000000000000000000000000000000000000000000000000000000000000000000000000000000000000000000101000000101000000101000000101000000101000000101000000101000000101000000101000000101000000
101000000101000000101000000101000000101000000101000000101000000101000000101000000101000000000000000000000000000000000000000000000000000000000000000000000000000000000000000000000000000000000000000000000000000000000000000000000000000000000000000000000000000000000000000000000000000000000000000000000000000000000000000000000000000000000000000000000000000000000000000000000101000000101000000101000000101000000101000000101000000101000000101000000101000000101000000
101000000101000000101000000101000000101000000101000000101000000101000000101000000101000000000000000000000000000000000000000000000000000000000000000000000000000000000000000000000000000000000000000000000000000000000000000000000000000000000000000000000000000000000000000000000000000000000000000000000000000000000000000000000000000000000000000000000000000000000000000000000101000000101000000101000000101000000101000000101000000101000000101000000101000000101000000
101000000101000000101000000101000000101000000101000000101000000101000000101000000101000000000000000000000000000000000000000000000000000000000000000000000000000000000000000000000000000000000000000000000000000000000000000000000000000000000000000000000000000000000000000000000000000000000000000000000000000000000000000000000000000000000000000000000000000000000000000000000101000000101000000101000000101000000101000000101000000101000000101000000101000000101000000
101000000101000000101000000101000000101000000101000000101000000101000000101000000101000000000000000000000000000000000000000000000000000000000000000000000000000000000000000000000000000000000000000000000000000000000000000000000000000000000000000000000000000000000000000000000000000000000000000000000000000000000000000000000000000000000000000000000000000000000000000000000101000000101000000101000000101000000101000000101000000101000000101000000101000000101000000
101000000101000000101000000101000000101000000101000000101000000101000000101000000101000000000000000000000000000000000000000000000000000000000000000000000000000000000000000000000000000000000000000000000000000000000000000000000000000000000000000000000000000000000000000000000000000000000000000000000000000000000000000000000000000000000000000000000000000000000000000000000101000000101000000101000000101000000101000000101000000101000000101000000101000000101000000
101000000101000000101000000101000000101000000101000000101000000101000000101000000101000000000000000000000000000000000000000000000000000000000000000000000000000000000000000000000000000000000000000000000000000000000000000000000000000000000000000000000000000000000000000000000000000000000000000000000000000000000000000000000000000000000000000000000000000000000000000000000101000000101000000101000000101000000101000000101000000101000000101000000101000000101000000
101000000101000000101000000101000000101000000101000000101000000101000000101000000101000000000000000000000000000000000000000000000000000000000000000000000000000000000000000000000000000000000000000000000000000000000000000000000000000000000000000000000000000000000000000000000000000000000000000000000000000000000000000000000000000000000000000000000000000000000000000000000101000000101000000101000000101000000101000000101000000101000000101000000101000000101000000
101000000101000000101000000101000000101000000101000000101000000101000000101000000101000000000000000000000000000000000000000000000000000000000000000000000000000000000000000000000000000000000000000000000000000000000000000000000000000000000000000000000000000000000000000000000000000000000000000000000000000000000000000000000000000000000000000000000000000000000000000000000101000000101000000101000000101000000101000000101000000101000000101000000101000000101000000
101000000101000000101000000101000000101000000101000000101000000101000000101000000101000000000000000000000000000000000000000000000000000000000000000000000000000000000000000000000000000000000000000000000000000000000000000000000000000000000000000000000000000000000000000000000000000000000000000000000000000000000000000000000000000000000000000000000000000000000000000000000101000000101000000101000000101000000101000000101000000101000000101000000101000000101000000
101000000101000000101000000101000000101000000101000000101000000101000000101000000101000000000000000000000000000000000000000000000000000000000000000000000000000000000000000000000000000000000000000000000000000000000000000000000000000000000000000000000000000000000000000000000000000000000000000000000000000000000000000000000000000000000000000000000000000000000000000000000101000000101000000101000000101000000101000000101000000101000000101000000101000000101000000
101000000101000000101000000101000000101000000101000000101000000101000000101000000101000000002000000000000000000000000000000000000000000000000000000000000000000000000000000000000000000000000000000000000000000000000000000000000002000000000000000000000000000000000000000000000000000000000000000000000000000000000000000000000000000000000000000000000000000000000000002000000101000000101000000101000000101000000101000000101000000101000000101000000101000000101000000
101000000101000000101000000101000000101000000101000000101000000101000000101000000101000000101000000101000000101000000101000000101000000101000000101000000101000000101000000101000000101000000101000000101000000101000000101000000101000000101000000101000000101000000101000000101000000101000000101000000101000000101000000101000000101000000101000000101000000101000000101000000101000000101000000101000000101000000101000000101000000101000000101000000101000000101000000
101000000101000000101000000101000000101000000101000000101000000101000000101000000101000000101000000101000000101000000101000000101000000101000000101000000101000000101000000101000000101000000101000000101000000101000000101000000101000000101000000101000000101000000101000000101000000101000000101000000101000000101000000101000000101000000101000000101000000101000000101000000101000000101000000101000000101000000101000000101000000101000000101000000101000000101000000
101000000101000000101000000101000000101000000101000000101000000101000000101000000101000000101000000101000000101000000101000000101000000101000000101000000101000000101000000101000000101000000101000000101000000101000000101000000101000000101000000101000000101000000101000000101000000101000000101000000101000000101000000101000000101000000101000000101000000101000000101000000101000000101000000101000000101000000101000000101000000101000000101000000101000000101000000
101000000101000000101000000101000000101000000101000000101000000101000000101000000101000000101000000101000000101000000101000000101000000101000000101000000101000000101000000101000000101000000101000000101000000101000000101000000101000000101000000101000000101000000101000000101000000101000000101000000101000000101000000101000000101000000101000000101000000101000000101000000101000000101000000101000000101000000101000000101000000101000000101000000101000000101000000
101000000101000000101000000101000000101000000101000000101000000101000000101000000101000000101000000101000000101000000101000000101000000101000000101000000101000000101000000101000000101000000101000000101000000101000000101000000101000000101000000101000000101000000101000000101000000101000000101000000101000000101000000101000000101000000101000000101000000101000000101000000101000000101000000101000000101000000101000000101000000101000000101000000101000000101000000
101000000101000000101000000101000000101000000101000000101000000101000000101000000101000000101000000101000000101000000101000000101000000101000000101000000101000000101000000101000000101000000101000000101000000101000000101000000101000000101000000101000000101000000101000000101000000101000000101000000101000000101000000101000000101000000101000000101000000101000000101000000101000000101000000101000000101000000101000000101000000101000000101000000101000000101000000
101000000101000000101000000101000000101000000101000000101000000101000000101000000101000000101000000101000000101000000101000000101000000101000000101000000101000000101000000101000000101000000101000000101000000101000000101000000101000000101000000101000000101000000101000000101000000101000000101000000101000000101000000101000000101000000101000000101000000101000000101000000101000000101000000101000000101000000101000000101000000101000000101000000101000000101000000
101000000101000000101000000101000000101000000101000000101000000101000000101000000101000000101000000101000000101000000101000000101000000101000000101000000101000000101000000101000000101000000101000000101000000101000000101000000101000000101000000101000000101000000101000000101000000101000000101000000101000000101000000101000000101000000101000000101000000101000000101000000101000000101000000101000000101000000101000000101000000101000000101000000101000000101000000
101000000101000000101000000101000000101000000101000000101000000101000000101000000101000000101000000101000000101000000101000000101000000101000000101000000101000000101000000101000000101000000101000000101000000101000000101000000101000000101000000101000000101000000101000000101000000101000000101000000101000000101000000101000000101000000101000000101000000101000000101000000101000000101000000101000000101000000101000000101000000101000000101000000101000000101000000
101000000101000000101000000101000000101000000101000000101000000101000000101000000101000000101000000101000000101000000101000000101000000101000000101000000101000000101000000101000000101000000101000000101000000101000000101000000101000000101000000101000000101000000101000000101000000101000000101000000101000000101000000101000000101000000101000000101000000101000000101000000101000000101000000101000000101000000101000000101000000101000000101000000101000000101000000
101000000101000000101000000101000000101000000101000000101000000101000000101000000101000000101000000101000000101000000101000000101000000101000000101000000101000000101000000101000000101000000101000000101000000101000000101000000101000000101000000101000000101000000101000000101000000101000000101000000101000000101000000101000000101000000101000000101000000101000000101000000101000000101000000101000000101000000101000000101000000101000000101000000101000000101000000
101000000101000000101000000101000000101000000101000000101000000101000000101000000101000000101000000101000000101000000101000000101000000101000000101000000101000000101000000101000000101000000101000000101000000101000000101000000101000000101000000101000000101000000101000000101000000101000000101000000101000000101000000101000000101000000101000000101000000101000000101000000101000000101000000101000000101000000101000000101000000101000000101000000101000000101000000
